2 2 2 0 0 0 1 1 0 0 0 0 5 5 5 5
2 1 2 2 0 0 1 1 0 0 0 0 0 5 5 5
2 1 2 2 2 0 1 1 0 0 0 0 0 0 0 5
2 2 2 2 0 0 1 1 0 3 3 3 3 3 3 5
2 2 2 0 0 0 1 1 0 3 4 4 4 4 3 5
2 2 0 0 0 1 1 0 0 3 4 4 4 4 3 0
2 1 0 0 1 1 0 0 0 3 3 4 4 3 3 0
1 1 0 0 1 1 0 0 0 0 0 1 1 0 0 0
0 1 1 1 1 1 1 1 1 1 1 1 1 1 1 1
0 0 0 0 1 1 1 1 1 1 1 1 1 1 1 1
5 5 0 0 1 1 0 0 0 0 0 0 0 0 0 0
5 5 5 0 1 1 0 0 0 0 0 0 0 0 0 0